...............
####..####.#.#.
...#..#....#.#.
.#.#..#....#.#.
.#.#..#....#.#.
.#.#..####.#.#.
.#.#.....#.#.#.
.#.#..##.#.#.#.
.#.#.....#.#.#.
.#.#..####.#.#.
...............
..###########..
...............
..###########..
...............