################################################################################
################################################################################
##.....................................##.....................................##
##.....................................##.....................................##
##.....................................##.....................................##
##.....................................##.....................................##
##.....................................##.....................................##
##.....................................##.....................................##
##.....................................##.....................................##
##.....................................##.....................................##
##.....................................##.....................................##
##.....................................##.....................................##
##.............................##......##......##.............................##
##..............................##.....##.....##..............................##
##...............................##....##....##...............................##
##................................##...##...##................................##
##.................................##..##..##.................................##
##..................................##.##.##..................................##
##...................................######...................................##
##....................................####....................................##
##.....................................##.....................................##
##............................................................................##
##............................................................................##
##............................................................................##
##............................................................................##
##............................................................................##
##............................................................................##
##............................................................................##
##............................................................................##
##..................###############...........###############.................##
##..................###############...........###############.................##
##..................##.....................................##.................##
##..................##.....................................##.................##
##..................##.....................................##.................##
##..................##.....................................##.................##
##..................##.....................................##.................##
##..................##.....................................##.................##
##..................##.....................................##.................##
##..................##.....................................##.................##
######################.....................................#####################
######################.....................................#####################
##..................##.....................................##.................##
##..................##.....................................##.................##
##..................##.....................................##.................##
##..................##.....................................##.................##
##..................##.....................................##.................##
##..................##.....................................##.................##
##..................##.....................................##.................##
##..................###############...........###############.................##
##..................###############...........###############.................##
##............................................................................##
##............................................................................##
##............................................................................##
##............................................................................##
##............................................................................##
##............................................................................##
##............................................................................##
##............................................................................##
##.....................................##.....................................##
##....................................####....................................##
##...................................######...................................##
##..................................##.##.##..................................##
##.................................##..##..##.................................##
##................................##...##...##................................##
##...............................##....##....##...............................##
##..............................##.....##.....##..............................##
##.............................##......##......##.............................##
##.....................................##.....................................##
##.....................................##.....................................##
##.....................................##.....................................##
##.....................................##.....................................##
##.....................................##.....................................##
##.....................................##.....................................##
##.....................................##.....................................##
##.....................................##.....................................##
##.....................................##.....................................##
##.....................................##.....................................##
##.....................................##.....................................##
################################################################################
################################################################################