################################################################################
#......................................##......................................#
#......................................##......................................#
#......................................##......................................#
#......................................##......................................#
#......................................##......................................#
#......................................##......................................#
#......................................##......................................#
#......................................##......................................#
#......................................##......................................#
#......................................##......................................#
#......................................##......................................#
#...............................#......##......#...............................#
#................................#............#................................#
#.................................#..........#.................................#
#..................................#........#..................................#
#...................................#......#...................................#
#....................................#....#....................................#
#.....................................#..#.....................................#
#......................................##......................................#
#..............................................................................#
#..............................................................................#
#..............................................................................#
#..............................................................................#
#..............................................................................#
#..............................................................................#
#..............................................................................#
#..............................................................................#
#..............................................................................#
#...................###############...........###############..................#
#...................#.......................................#..................#
#...................#.......................................#..................#
#...................#.......................................#..................#
#...................#.......................................#..................#
#...................#.......................................#..................#
#...................#.......................................#..................#
#...................#.......................................#..................#
#...................#.......................................#..................#
#...................#.......................................#..................#
#####################.......................................####################
#...................#.......................................#..................#
#...................#.......................................#..................#
#...................#.......................................#..................#
#...................#.......................................#..................#
#...................#.......................................#..................#
#...................#.......................................#..................#
#...................#.......................................#..................#
#...................#.......................................#..................#
#...................#.......................................#..................#
#...................###############...........###############..................#
#..............................................................................#
#..............................................................................#
#..............................................................................#
#..............................................................................#
#..............................................................................#
#..............................................................................#
#..............................................................................#
#..............................................................................#
#..............................................................................#
#......................................##......................................#
#.....................................#..#.....................................#
#....................................#....#....................................#
#...................................#......#...................................#
#..................................#........#..................................#
#.................................#..........#.................................#
#................................#............#................................#
#...............................#..............#...............................#
#......................................##......................................#
#......................................##......................................#
#......................................##......................................#
#......................................##......................................#
#......................................##......................................#
#......................................##......................................#
#......................................##......................................#
#......................................##......................................#
#......................................##......................................#
#......................................##......................................#
#......................................##......................................#
#......................................##......................................#
################################################################################
